111111111111111111111111111111111111
1E0000000000000C00000C0000M000000001
101001010010000010100100000001010001
100001001010101000100100000001010001
1P0000000C00C0000000000000000C10C001
101001010010000010100100000001010001
1010010100100C0010100100000001010001
111111111111111111111111111111111111