1111111111111111111111111111111111
1000000000000000000000000000000001
1010010100100000101001000000010101
10000100101010100010010000000101E1
1P00000000000000000000000000000001
1111111111111111111111111111111111