11111111111
100E0000001
10100101001
10000100101
1P0000000C1
11111111111