11111111111111111111111111111111111111111111111111111111111111111111111111111111111111111111111111111111111111111111111111111111111111111111111111111111
100000000000000C00000C0000000000000000000000000000000000000000000000000000000000000000000000000000000000000000000000000000000000000000000000000000000001
10100101001000001010010000000101000000000000000000000000000000000000000000000000000000000000000000000000000000000000000000000000000000000000000000000001
10000100101010100010010000000101E00000000000000000000000000000000000000000000000000000000000000000000000000000000000000000000000000000000000000000000001
1P0000000C00C0000000000000000000C00000000000000000000000000000000000000000000000000000000000000000000000000000000000000000000000000000000000000000000001
10100101001000001010010000000101000000000000000000000000000000000000000000000000000000000000000000000000000000000000000000000000000000000000000000000001
10100101001000001010010000000101000000000000000000000000000000000000000000000000000000000000000000000000000000000000000000000000000000000000000000000001
10100101001000001010010000000101000000000000000000000000000000000000000000000000000000000000000000000000000000000000000000000000000000000000000000000001
10100101001000001010010000000101000000000000000000000000000000000000000000000000000000000000000000000000000000000000000000000000000000000000000000000001
10100101001000001010010000000101000000000000000000000000000000000000000000000000000000000000000000000000000000000000000000000000000000000000000000000001
10100101001000001010010000000101000000000000000000000000000000000000000000000000000000000000000000000000000000000000000000000000000000000000000000000001
10100101001000001010010000000101000000000000000000000000000000000000000000000000000000000000000000000000000000000000000000000000000000000000000000000001
10100101001000001010010000000101000000000000000000000000000000000000000000000000000000000000000000000000000000000000000000000000000000000000000000000001
10100101001000001010010000000101000000000000000000000000000000000000000000000000000000000000000000000000000000000000000000000000000000000000000000000001
10100101001000001010010000000101000000000000000000000000000000000000000000000000000000000000000000000000000000000000000000000000000000000000000000000001
10100101001000001010010000000101000000000000000000000000000000000000000000000000000000000000000000000000000000000000000000000000000000000000000000000001
11001010010000010100100000001010000000000000000000000000000000000000000000000000000000000000000000000000000000000000000000000000000000000000000000000011
11001010010000010100100000001010000000000000000000000000000000000000000000000000000000000000000000000000000000000000000000000000000000000000000000000011
11001010010000010100100000001010000000000000000000000000000000000000000000000000000000000000000000000000000000000000000000000000000000000000000000000011
11001010010000010100100000001010000000000000000000000000000000000000000000000000000000000000000000000000000000000000000000000000000000000000000000000011
11001010010000010100100000001010000000000000000000000000000000000000000000000000000000000000000000000000000000000000000000000000000000000000000000000011
11001010010000010100100000001010000000000000000000000000000000000000000000000000000000000000000000000000000000000000000000000000000000000000000000000011
10100101001000001010010000000101000000000000000000000000000000000000000000000000000000000000000000000000000000000000000000000000000000000000000000000001
10100101001000001010010000000101000000000000000000000000000000000000000000000000000000000000000000000000000000000000000000000000000000000000000000000001
10100101001000001010010000000101000000000000000000000000000000000000000000000000000000000000000000000000000000000000000000000000000000000000000000000001
10100101001000001010010000000101000000000000000000000000000000000000000000000000000000000000000000000000000000000000000000000000000000000000000000000001
10100101001000001010010000000101000000000000000000000000000000000000000000000000000000000000000000000000000000000000000000000000000000000000000000000001
10100101001000001010010000000101000000000000000000000000000000000000000000000000000000000000000000000000000000000000000000000000000000000000000000000001
10100101001000001010010000000101000000000000000000000000000000000000000000000000000000000000000000000000000000000000000000000000000000000000000000000001
10100101001000001010010000000101000000000000000000000000000000000000000000000000000000000000000000000000000000000000000000000000000000000000000000000001
10100101001000001010010000000101000000000000000000000000000000000000000000000000000000000000000000000000000000000000000000000000000000000000000000000001
11111111111111111111111111111111111111111111111111111111111111111111111111111111111111111111111111111111111111111111111111111111111111111111111111111111
