1111111111111111111111111111111111
1EEEEEEEEEEEEEEC00000C000000000001
1010010100100000101001000000010101
1000010010101010001001EEEEEEEE01E1
1P0000000C00C0000000000E00000000E1
1111111111111111111111111111111111