1111111111111111111111111111111111
1P000000000P000C00000C00P000000001
1010010100100000101001000000010101
10000100101010100010010000000101E1
1P0000000C00C00000P0000000000000P1
1111111111111111111111111111111111